I I K I I I I I I I I I I I I I I I I I I I I I I I I I I I I I I I I I I I I I I I I I I I I I I I I I I I I I I I I I I I I I I I I I I I I I I I I I I I I I I I I I I I I I I I I I
I K J ! I I ? I I I I I I I I I I I I I I I I I I I I I I I I I A I I I I I I I I I I I I I I I I I I I I I I I I I I I I I I I I I I I I I I I I I I I I I I I I I I I I I I I I I I I
I I J I I I I I I I I I I I I I I I I I I I I I I I I I K K B I I I I K K U I I I I I I I I I I I I I I I I I I I I I I I I I I I I I I I I I I I I I I I I I I I I I I I I I I I I I I
I K J K _ I A I I Z I A I U I I I I I I I I I I I I I I I I I I I I I I I K I I I I I I I I I I I I I I I I I I I I I I I I I I I I I I I I I I I I I I I I I I I I I I I I I I I I I I
_ _ _ _ B _ _ _ _ D K K K K I _ _ _ _ ? I _ I _ _ I I _ _ _ _ _ I I _ _ _ _ K I _ _ I _ I _ _ I _ _ _ _ _ _ _ K K K K K I _ _ _ _ _ I _ I _ _ _ I _ _ _ _ _ I I _ _ _ _ K I _ _ I _ I _
_ I I _ I _ _ _ N _ _ _ I _ _ _ K _ _ I _ I _ _ _ _ _ I I _ I _ I _ I I _ _ _ I _ K I I _ _ _ I I _ I _ _ _ _ _ _ _ I _ _ _ _ K _ I _ I _ _ _ K _ I I _ I _ I _ I I _ _ _ I _ K I I _ _
_ P Q U _ _ T _ _ _ _ _ _ _ _ _ _ _ _ _ U Q _ E U _ _ P _ V _ _ _ _ _ _ _ _ P _ _ _ _ _ P Q _ _ Q _ U _ _ _ _ _ _ _ _ _ _ U K L K _ U U _ _ K _ _ P U Q _ _ _ _ _ _ _ _ _ _ _ _ _ _ _ _
K K K K K K K K K K _ _ _ _ _ _ _ _ _ K K K K K L L L K K K K L M M M M M L K L M M M M K K _ _ K K K K Y Y K K _ _ _ _ _ K L L L K K K K K L L L K K K K L M M M M M L K K K K K K K K
L L L L L L L L L L _ _ _ _ _ _ _ _ _ L L L L L L L L L L L L L _ _ _ _ _ _ L L R R R R R R R R R L L S S S S L _ _ _ _ L L L L L L L L L L L L L L L L L L _ _ _ _ _ L L L L L L L L L
J J L L L L L J J J _ _ _ _ _ _ _ _ _ L J J J J L L L J J J J L _ _ _ _ _ _ J J J L L L L J J J L L L L L J J J _ _ _ J J J J J L L J J J J L L L J J J _ _ _ _ _ _ _ _ J J J L L L L J
J J J L L L J L L J _ _ _ _ _ _ _ _ _ L J J L L L J J J J J J _ _ _ _ _ _ _ J J L L L J J J J J J L L L J L L J _ _ J J J J J J J L J J L L L J J J J J _ _ _ _ _ _ _ _ _ _ L L L J J J
J J J L L L J L L J _ _ _ _ _ _ _ _ C L J J L L L J J J J J _ _ _ _ _ _ _ _ _ J L L L J J J J J J L L L J L L J _ _ J J J J J J J L J J L L L J J J J J _ _ _ _ _ _ _ _ _ _ L L L J J J
J J J J J J J J J J K K J J J J J J J J J J J J J J J J J _ _ _ _ _ _ _ _ _ _ _ J J J J J J J J J J J J J J J J J J J J J J J J J J J J J J J J J J _ _ _ _ _ _ _ _ _ _ _ _ _ J J J J J
J J J J J J J J J J J J J J J J J J J J J J J J J J J J J _ _ _ _ _ _ _ _ _ _ _ J J J J J J J J J J J J J J J J J J J J J J J J J J J J J J J J J _ _ _ _ _ _ _ _ _ _ _ _ _ _ _ _ J J J
J J J J J J J J J J J J J J J J J J J J J J J J J J J J J _ _ _ _ _ _ _ _ _ _ _ _ J J J J J J J J J J J J J J J J J J J J J J J J J J J J J J _ _ _ _ _ _ _ _ _ _ _ _ _ _ _ _ _ _ _ J J
J J J J J J J J J J J J J J J J J J J J J J J J J J J J _ _ _ _ _ _ _ _ _ _ _ _ _ J J J J J J J J J J J J J J J J J J J J J J J J J J J J J J _ _ _ _ _ _ _ _ _ _ _ _ _ _ _ _ _ _ _ J J
J J J J J J J J J J J J J J J J J J J J J J J J J J J J _ _ _ _ _ _ _ _ _ _ _ _ _ _ J J J J J J J J J J J J J J J J J J J J J J J J J J J J J _ _ _ _ _ _ _ _ _ _ _ _ _ _ _ _ _ _ _ _ J
J J J J J J J J J J J J J J J J J J J J J J J J J J J J _ _ _ _ _ _ _ _ _ _ _ _ _ _ _ J J J J J J J J J J J J J J J J J J J J J J J J J J J _ _ _ _ _ _ _ _ _ _ _ _ _ _ _ _ _ _ _ _ _ _
J J J J J J J J J J J J J J J J J J J J J J J J J J J J _ _ _ _ _ _ _ _ _ _ _ _ _ _ _ J J J J J J J J J J J J J J J J J J J J J J J J J J J _ _ _ _ _ _ _ _ _ _ _ _ _ _ _ _ _ _ _ _ _ _
