0 0 2 0 0 0 0 0 0 0 0 0 0 0 0 0 0 0 0 0 0 0 0 0 0 0 0 0 0 0 0 0 0 0 0 0 0 0 0 0 0 0 0 0 0 0
0 2 1 0 0 0 0 0 0 0 0 0 0 0 0 0 0 0 0 0 0 0 0 0 0 0 0 0 0 0 0 0 0 0 0 0 0 0 0 0 0 0 0 0 0 0
0 0 1 0 0 0 0 0 0 0 0 0 0 0 0 0 0 0 0 0 0 0 0 0 0 0 0 0 0 0 0 0 0 0 0 0 0 0 0 0 0 0 0 0 0 0
0 0 1 0 0 0 0 0 0 0 0 0 0 0 0 0 0 0 0 0 0 0 0 0 0 0 0 0 0 0 0 0 0 0 0 0 0 0 0 0 0 0 0 0 0 0
0 0 1 0 0 0 0 0 0 0 0 5 0 5 0 0 0 0 0 0 0 0 0 0 0 0 0 0 0 0 0 0 0 0 0 0 0 0 0 0 0 0 0 0 0 0
9 2 1 2 9 9 7 9 9 2 2 2 2 2 0 9 9 9 9 9 0 9 0 9 9 9 0 9 9 9 9 9 0 0 9 9 9 9 9 0 9 9 0 9 0 9
9 0 0 9 0 9 9 9 6 9 9 9 0 9 9 9 9 2 9 0 9 0 9 9 9 2 9 0 0 9 0 9 0 9 0 0 9 9 9 0 9 9 0 0 9 9
9 8 8 9 5 9 9 9 9 9 9 9 9 9 9 5 2 2 2 9 5 5 9 9 2 2 2 9 9 9 9 9 9 9 9 9 9 9 9 9 9 9 9 9 9 9
2 2 2 2 2 2 2 2 2 2 9 9 9 9 9 2 3 3 3 2 2 2 2 2 3 3 3 2 2 2 2 3 4 4 4 4 4 3 2 2 2 2 2 2 2 2
3 3 3 3 3 3 3 3 3 3 9 9 9 9 3 3 3 3 3 3 3 3 3 3 3 3 3 3 3 3 3 3 9 9 9 9 9 3 3 3 3 3 3 3 3 3
1 1 3 3 3 3 3 1 1 1 9 9 9 1 1 1 1 1 3 3 1 1 1 1 3 3 3 1 1 1 1 3 9 9 9 9 9 3 1 1 1 3 3 3 3 1
1 1 1 3 3 3 1 3 3 1 9 9 1 1 1 1 1 1 1 3 1 1 3 3 3 1 1 1 1 1 1 1 9 9 9 9 9 1 1 1 3 3 3 1 1 1
1 1 3 1 1 3 1 1 1 1 9 1 1 1 1 1 1 1 1 1 1 1 3 3 1 1 1 1 1 1 1 1 9 9 9 9 9 1 1 1 1 1 1 1 1 1
1 1 1 1 1 1 1 1 1 1 1 1 1 1 1 1 1 1 1 1 1 1 1 1 1 1 1 1 1 1 1 1 9 9 9 9 9 1 1 1 1 1 1 1 1 1
1 1 1 1 1 1 1 1 1 1 1 1 1 1 1 1 1 1 1 1 1 1 1 1 1 1 1 1 1 1 1 1 9 9 9 9 9 1 1 1 1 1 1 1 1 1
1 1 1 1 1 1 1 1 1 1 1 1 1 1 1 1 1 1 1 1 1 1 1 1 1 1 1 1 1 1 1 1 9 9 9 9 9 1 1 1 1 1 1 1 1 1
1 1 1 1 1 1 1 1 1 1 1 1 1 1 1 1 1 1 1 1 1 1 1 1 1 1 1 1 1 1 1 1 9 9 9 9 9 1 1 1 1 1 1 1 1 1
1 1 1 1 1 1 1 1 1 1 1 1 1 1 1 1 1 1 1 1 1 1 1 1 1 1 1 1 1 1 1 1 9 9 9 9 9 1 1 1 1 1 1 1 1 1
1 1 1 1 1 1 1 1 1 1 1 1 1 1 1 1 1 1 1 1 1 1 1 1 1 1 1 1 1 1 1 1 9 9 9 9 9 1 1 1 1 1 1 1 1 1
