0 0 2 0 0 0 0 0 0 0 0 0 0 0 0 0 0 0 0 0 0 0 0 0 0 0 0 0 0 0 0 0 0 0 0 0 0 0 0 0 0 0 0 0 0 0 0 0 0 0 0 0 0 0 0 0 0 0 0 0 0 0 0 0 0 0 0 0 0 0 0 0 0 0 0 0 0 0 0 0 0 0 0 0 0 0 0 0 0 0 0 0
0 2 1 0 0 0 0 0 0 0 0 0 0 0 0 0 0 0 0 0 0 0 0 0 0 0 0 0 0 0 0 0 0 0 0 0 0 0 0 0 0 0 0 0 0 0 0 0 0 0 0 0 0 0 0 0 0 0 0 0 0 0 0 0 0 0 0 0 0 0 0 0 0 0 0 0 0 0 0 0 0 0 0 0 0 0 0 0 0 0 0 0
0 0 1 0 0 0 0 0 0 0 0 0 0 0 0 0 0 0 0 0 0 0 0 0 0 0 0 0 0 0 0 P P P 0 0 0 0 0 0 0 0 0 0 0 0 0 0 0 0 0 0 0 0 0 0 0 0 0 0 0 0 0 0 0 0 0 0 0 0 0 0 0 0 0 0 0 0 0 0 0 0 0 0 0 0 0 0 0 0 0 0
0 0 1 0 0 0 0 0 0 0 0 0 0 0 0 0 0 0 0 0 0 0 0 0 0 0 0 0 0 2 Y 0 0 0 0 2 2 G 0 0 0 0 0 0 0 0 0 0 0 0 0 0 0 0 0 0 0 0 0 0 0 0 0 0 0 0 0 0 0 0 0 0 0 0 0 0 0 0 0 0 0 0 0 0 0 0 0 0 0 0 0 0
0 2 1 2 _ 0 P 0 0 0 0 P 0 G 0 0 0 0 0 0 0 0 0 0 0 0 0 0 0 0 0 0 0 0 0 0 0 2 0 0 0 0 0 0 0 0 0 0 0 0 0 0 0 0 0 0 0 0 0 0 0 0 0 0 0 0 0 0 0 0 0 0 0 0 0 0 0 0 0 0 0 0 0 0 0 0 0 0 0 0 0 0
_ _ _ _ Y _ _ _ _ 2 E 2 2 2 0 _ _ _ _ _ 0 _ 0 _ _ 0 0 _ _ _ _ _ 0 0 _ _ _ _ 2 0 _ _ 0 _ 0 _ _ 0 _ _ _ _ _ _ _ 2 2 2 2 2 0 _ _ _ _ _ 0 _ 0 _ _ _ 0 _ _ _ _ _ 0 0 _ _ _ _ 2 0 _ _ 0 _ 0 _
_ 0 0 _ 0 _ _ _ 6 _ _ _ 0 _ _ _ 2 _ _ 0 _ 0 _ _ _ _ _ 0 0 _ 0 _ 0 _ 0 0 _ _ _ 0 _ 2 0 0 _ _ _ 0 0 _ 0 _ _ _ _ _ _ _ 0 _ _ _ _ 2 _ 0 _ 0 _ _ _ 2 _ 0 0 _ 0 _ 0 _ 0 0 _ _ _ 0 _ 2 0 0 _ _
_ 8 9 _ G _ B _ _ _ _ _ _ _ _ _ _ _ _ _ G G _ Q G _ _ 8 G 8 _ _ _ _ _ _ _ _ 8 _ _ _ _ _ 8 9 _ _ 9 _ G _ _ _ _ _ _ _ _ _ _ G 2 3 2 _ G G _ _ 2 _ _ 8 G 9 _ _ _ _ _ _ _ _ _ _ _ _ _ _ _ _
2 2 2 2 2 2 2 2 2 2 _ _ _ _ _ _ _ _ _ 2 2 2 2 2 3 3 3 2 2 2 2 3 4 4 4 4 4 3 2 3 4 4 4 4 2 2 _ _ 2 2 2 2 D D 2 2 _ _ _ _ _ 2 3 3 3 2 2 2 2 2 3 3 3 2 2 2 2 3 4 4 4 4 4 3 2 2 2 2 2 2 2 2
3 3 3 3 3 3 3 3 3 3 _ _ _ _ _ _ _ _ _ 3 3 3 3 3 3 3 3 3 3 3 3 3 _ _ _ _ _ _ 3 3 L L L L L L L L L 3 3 W W W W 3 _ _ _ _ 3 3 3 3 3 3 3 3 3 3 3 3 3 3 3 3 3 3 _ _ _ _ _ 3 3 3 3 3 3 3 3 3
1 1 3 3 3 3 3 1 1 1 _ _ _ _ _ _ _ _ _ 3 1 1 1 1 3 3 3 1 1 1 1 3 _ _ _ _ _ _ 1 1 1 3 3 3 3 1 1 1 3 3 3 3 3 1 1 1 _ _ _ 1 1 1 1 1 3 3 1 1 1 1 3 3 3 1 1 1 _ _ _ _ _ _ _ _ 1 1 1 3 3 3 3 1
1 1 1 3 3 3 1 3 3 1 _ _ _ _ _ _ _ _ _ 3 1 1 3 3 3 1 1 1 1 1 1 _ _ _ _ _ _ _ 1 1 3 3 3 1 1 1 1 1 1 3 3 3 1 3 3 1 _ _ 1 1 1 1 1 1 1 3 1 1 3 3 3 1 1 1 1 1 _ _ _ _ _ _ _ _ _ _ 3 3 3 1 1 1
1 1 1 3 3 3 1 3 3 1 _ _ _ _ _ _ _ _ R 3 1 1 3 3 3 1 1 1 1 1 _ _ _ _ _ _ _ _ _ 1 3 3 3 1 1 1 1 1 1 3 3 3 1 3 3 1 _ _ 1 1 1 1 1 1 1 3 1 1 3 3 3 1 1 1 1 1 _ _ _ _ _ _ _ _ _ _ 3 3 3 1 1 1
1 1 1 1 1 1 1 1 1 1 2 2 1 1 1 1 1 1 1 1 1 1 1 1 1 1 1 1 1 _ _ _ _ _ _ _ _ _ _ _ 1 1 1 1 1 1 1 1 1 1 1 1 1 1 1 1 1 1 1 1 1 1 1 1 1 1 1 1 1 1 1 1 1 1 _ _ _ _ _ _ _ _ _ _ _ _ _ 1 1 1 1 1
1 1 1 1 1 1 1 1 1 1 1 1 1 1 1 1 1 1 1 1 1 1 1 1 1 1 1 1 1 _ _ _ _ _ _ _ _ _ _ _ 1 1 1 1 1 1 1 1 1 1 1 1 1 1 1 1 1 1 1 1 1 1 1 1 1 1 1 1 1 1 1 1 1 _ _ _ _ _ _ _ _ _ _ _ _ _ _ _ _ 1 1 1
1 1 1 1 1 1 1 1 1 1 1 1 1 1 1 1 1 1 1 1 1 1 1 1 1 1 1 1 1 _ _ _ _ _ _ _ _ _ _ _ _ 1 1 1 1 1 1 1 1 1 1 1 1 1 1 1 1 1 1 1 1 1 1 1 1 1 1 1 1 1 1 _ _ _ _ _ _ _ _ _ _ _ _ _ _ _ _ _ _ _ 1 1
1 1 1 1 1 1 1 1 1 1 1 1 1 1 1 1 1 1 1 1 1 1 1 1 1 1 1 1 _ _ _ _ _ _ _ _ _ _ _ _ _ 1 1 1 1 1 1 1 1 1 1 1 1 1 1 1 1 1 1 1 1 1 1 1 1 1 1 1 1 1 1 _ _ _ _ _ _ _ _ _ _ _ _ _ _ _ _ _ _ _ 1 1
1 1 1 1 1 1 1 1 1 1 1 1 1 1 1 1 1 1 1 1 1 1 1 1 1 1 1 1 _ _ _ _ _ _ _ _ _ _ _ _ _ _ 1 1 1 1 1 1 1 1 1 1 1 1 1 1 1 1 1 1 1 1 1 1 1 1 1 1 1 1 1 _ _ _ _ _ _ _ _ _ _ _ _ _ _ _ _ _ _ _ _ 1
1 1 1 1 1 1 1 1 1 1 1 1 1 1 1 1 1 1 1 1 1 1 1 1 1 1 1 1 _ _ _ _ _ _ _ _ _ _ _ _ _ _ _ 1 1 1 1 1 1 1 1 1 1 1 1 1 1 1 1 1 1 1 1 1 1 1 1 1 1 1 _ _ _ _ _ _ _ _ _ _ _ _ _ _ _ _ _ _ _ _ _ _
